5 10
|--------|
|.A.|..-.|
|..-|.@..|
|.A....-.|
|--------|